11111
1C001
100E1
10P01
11111
