11111
1C1E1
10001
10P01
11111
